1 15 31 0
###############################
#       fs     *   *  * * *   #
# # # #*# #5#*#*# # # #*#*#*# #
#   *     ***  * 1    *   * * #
# # # # # #*# # #*#*# # # # #*#
#        4 # **  *  *         #
# # # # # # # # # #*# #*# # # #
#*3 *      *  *      *        #
# # # # #*# # # #*#*# # # # # #
#*    **  *       *           #
# #*# # # # # # #*# # # # # # #
#*    **  *     *2*           #
# #*# # # # # # #*# # # # # # #
#           *   *  *          #
###############################

