1 10 16
################
#      * * *   #
# # # # *# #*# #
#   *      * * #
# # #* # # # # #
#              #
# # # # #  # # #
# #  # # # # # #
#    *  *      #
################