1 15 31 0
###############################
#              *   *  * * *   #
# # # #*# # #*#*# # # #*#*#*# #
#   *     ***  * 1    *   * * #
# # # # # #*# # #*#*# # # # #*#
#          # **  *  *         #
# # # # # # # # # #*# #*# # # #
#*  *      *  *      *        #
# # # # #*# # # #*#*# # # # # #
#*    **  *       *           #
# #*# # # # # # #*# # # # # # #
#*    **  *     *2*           #
# #*# # # # # # #*# # # # # # #
#           *   *  *          #
###############################

